11 8 8 8 8 8 8 8 8 8 8 8 8 8 8 8 8 8 8 8 8 8 8 11
10 3 0 0 4 15 3 0 0 0 0 0 0 0 4 15 3 0 0 0 0 2 4 9
10 1 11 11 1 15 1 13 13 15 15 15 15 13 1 12 2 13 13 13 13 1 1 9
10 1 12 15 1 15 1 11 11 3 0 0 4 11 1 15 1 11 11 11 11 1 1 9
10 6 0 0 2 0 2 0 0 5 11 11 1 14 1 15 2 0 2 0 0 2 2 9
10 15 15 15 1 13 13 11 11 11 11 11 2 0 5 15 1 11 1 11 11 1 1 9
10 3 0 0 2 15 15 3 0 0 0 2 5 11 11 11 1 12 1 14 14 1 1 9
10 1 13 13 1 14 14 1 15 15 15 1 11 14 14 14 1 11 6 0 0 2 1 9
10 1 11 11 6 0 0 5 15 15 15 1 14 3 0 0 2 4 13 13 13 1 1 9
10 1 15 15 15 15 15 15 15 15 15 6 2 2 13 13 13 2 4 11 11 1 1 9
10 1 15 3 0 0 0 0 4 15 3 0 2 2 11 11 11 1 1 15 15 1 1 9
10 1 15 1 14 14 14 15 1 15 1 11 1 1 14 14 14 1 1 15 15 1 1 9
10 1 11 6 0 2 2 15 1 15 1 11 1 2 0 0 0 2 1 12 15 1 1 9
10 1 14 11 13 2 2 15 2 15 1 11 1 1 11 11 11 1 1 11 11 1 1 9
10 6 0 4 11 1 11 11 1 11 1 11 1 2 0 0 0 2 1 14 14 1 1 9
10 15 15 1 14 1 12 11 1 14 1 14 1 1 13 13 13 1 6 0 0 5 1 9
10 15 15 6 0 5 11 11 6 0 2 0 2 5 11 11 11 6 0 0 0 0 5 9
11 7 7 7 7 7 7 7 7 7 7 7 7 7 7 7 7 7 7 7 7 7 7 11