11 8 8 8 8 8 8 8 8 8 8 8 8 8 8 8 8 8 8 8 8 8 8 11
10 3 0 0 2 2 0 0 4 11 3 0 0 0 4 11 3 0 0 2 2 0 4 11
10 1 3 0 2 2 0 4 1 11 1 3 0 4 1 11 1 3 0 2 2 11 1 11
10 1 1 12 1 1 11 1 1 11 1 1 11 1 1 11 1 1 11 1 1 12 1 11
10 1 1 11 1 1 11 1 1 11 1 1 11 1 1 11 1 1 11 1 1 11 1 11
10 2 2 0 2 2 0 2 2 2 2 2 0 2 2 11 2 2 0 2 2 0 2 11
10 2 2 0 2 2 0 2 2 2 2 2 0 2 2 11 2 2 0 2 2 0 2 11
10 1 1 11 1 1 11 1 1 11 1 1 11 1 1 11 1 1 11 1 1 11 1 11
10 1 1 11 1 1 11 1 1 11 1 1 11 1 1 11 1 1 11 1 1 11 1 11
10 2 2 0 2 2 0 2 2 11 1 1 11 1 1 11 1 1 11 1 1 11 1 11
10 2 2 0 2 2 0 2 2 11 1 1 11 1 1 11 1 1 11 1 1 11 1 11
10 1 1 11 1 1 11 1 1 11 2 2 0 2 2 2 2 2 0 2 2 0 2 11
10 1 1 11 1 1 11 1 1 11 2 2 0 2 2 2 2 2 0 2 2 0 2 11
10 1 1 11 1 1 11 1 1 11 1 1 11 1 1 11 1 1 11 1 1 11 1 11
10 1 1 12 1 1 11 1 1 11 1 1 11 1 1 11 1 1 11 1 1 12 1 11
10 1 6 0 2 2 0 5 1 11 1 6 0 5 1 11 1 6 0 2 2 11 1 10
10 6 0 0 2 2 0 0 5 11 6 0 0 0 5 11 6 0 0 2 2 0 5 10
11 7 7 7 7 7 7 7 7 7 7 7 7 7 7 7 7 7 7 7 7 7 7 11